********************
*** **             *
*** *****E*****C****
*** ***** ***** ***R
E                   
*** ** ** ** ** ****
*** ** ** ** ** **R*
*                  *
*** ** ** ** ** ****
*** ** ** ** ** ****
***                *
*** ** ** ** ** ****
*** **  E ** *R ****
*** *****         C*
*** *****C***** ****
